scaffold	position_A	position_B	distance	r2	d_prime	r2_normalized	d_prime_normalized	allele_A	allele_a	allele_B	allele_b	countab	countAb	countaB	countAB	total
4	61143	61145	2	1.0000000000000004	1.0			A	C	G	A	3	0	0	25	28
4	61145	61250	105	1.0	1.0	1.0	1.0	G	A	C	G	3	0	0	19	22
4	67607	67633	26	0.02387267904509284	1.0			A	T	G	A	0	6	3	23	32
4	67607	67635	28	0.025599999999999658	1.0	0.002770083102493075	1.0	A	T	G	A	0	4	4	21	29
4	67607	67636	29	0.02597402597402596	1.0	0.044117647058823525	1.0	A	T	A	T	0	4	3	18	25
4	67633	67635	2	0.9999999999999998	1.0			G	A	G	A	2	0	0	37	39
4	67633	67636	3	1.0000000000000004	1.0	0.9999999999999998	1.0	G	A	A	T	2	0	0	34	36
4	67633	67637	4					G	A	A	T	0	0	0	33	33
4	67635	67636	1	0.9999999999999996	1.0	1.0	1.0	G	A	A	T	2	0	0	35	37
4	67635	67637	2					G	A	A	T	0	0	0	34	34
4	67636	67637	1					A	T	A	T	0	3	0	34	37
